1111111111111
1E00000000001
1010010100101
1010000010101
1P0000000C001
1111111111111
