1111111111111111111111
10P000000C000000000001
1111111111111111111001
1000C0010B00C000C00001
1001111111001111111111
10C000000E000C00B00001
1111111111111111111111
