1111111111111111111111
100000000C000000000001
10000000000000B0001101
10100000000P0000C01101
100000B000000BB0000001
10C0000000C00000B000E1
1111111111111111111111
