1111111111111111111111
100000000C000000000001
1000000000000000001101
10100000000P0000C01101
1000000000000BB0000001
10C0000000C00000B000E1
1111111111111111111111
