1111111111111111
1PEC000000000001
1000000000000001
1000000000000001
1000000000000001
100000B000000001
1000001000000001
10000000CCC00001
1000000000000001
1000000000000001
1000CCCCC0000001
1000000000000001
1000000000000001
1000000000000001
1000000000000001
1000000000000001
1111111111111111
